1111111111111
10010000000C1
1001011111001
1P0011E000001
111111111111