1111111111111
100100P0000C1
10000111110P1
1P0011E000001
1111111111111