1111111111111
10E10000000C1
1000011111E01
1P0011E000E01
1111111111111