1111111111111
10010000000C1
011111001
1P000001
1111111111111